+++++++++++++++++++++++++*
+----------+++----------+*
+-+++-++++-+++-++++-+++-+*
+-+++-++++-+++-++++-+++-+*
+-----------------------+*
+-+++-+-+++++++++-+-+++-+*
+-----+----+++----+-----+*
+++++-++++.+++.++++-+++++*
....+-+...........+-+....*
....+-+.+++...+++.+-+....*
+++++-+.+.......+.+-+++++*
.....-..+.......+........*
+++++-+.+.......+.+-+++++*
....+-+.+++++++++.+-+....*
....+-+...........+-+....*
+++++-+.+++++++++.+-+++++*
+----------+++----------+*
+-+++-++++-+++-++++-+++-+*
+---+---------------+---+*
+++-+-+-+++++++++-+-+-+++*
+-----+----+++----+-----+*
+-++++++++-+++-++++++++-+*
+-+---+----+++----+---+-+*
+---+---+-------+---+---+*
+++++++++++++++++++++++++*
