++++++++++++.++++++++++++*
++++----++++.++++----++++*
+----------+.+----------+*
+-+++--+++-+.+-+++--+++-+*
+-+------+-+.+-+------+-+*
+---++++---+.+---++++---+*
+++-+..+---+.+---+..+-+++*
...-+..+---+.+---+..+-...*
...-+..+---+.+---+..+-...*
+++-+..+---+.+---+..+-+++*
+---++++---+.+---++++---+*
+-+------+-+.+-+------+-+*
+-+++--+++-+.+-+++--+++-+*
+----------+.+----------+*
+-++--++-+++++++-++--++-+*
+-+----+-+.....+-+----+-+*
+---++---+.....+---++---+*
+-+----+-++...++-+----+-+*
+-++--++---------++--++-+*
+-+----+-+-----+-+----+-+*
+-+-++-+-+-+++-+-+-++-+-+*
+-+-++-+-+--+--+---++-+-+*
+-+-++-+-+--+--+---++-+-+*
+---++---+-----+---++---+*
+++++++++++++++++++++++++*
