+++++++++++++++++++++++++*
.......++-------++.......*
.......++--+++--++.......*
++++++.++-+++++-++.++++++*
+----------+++----------+*
+-++++++-+-+++-+-++++++-+*
+-+------+-----+------+-+*
+-+-++++.+++++++.++++-+-+*
+------+.........+------+*
++++++-+.++...++.+-++++++*
+------+.+.....+.+------+*
+-++++-+.+.....+.+-++++-+*
+----+-..+.....+..-+----+*
+-+----..+++++++..----+-+*
++++-+-+.........+-+-++++*
...+-+-+++.+++.+++-+-+...*
...+-------+++-------+...*
++++-+++++-+++-+++++-++++*
....----+-------+----....*
....-+--+--+++--+--+-....*
++++-+--+-+++++-+--+-++++*
+----+-----+++-----+----+*
+-++++-+++-+++-+++-++++-+*
+-----------------------+*
+++++++++++++++++++++++++*
